111111111111
1B01000000C1
100001111001
1P0011E000B1
111111111111